R 1600 720
F 220,100,0
C 255,30,0
NO ./path_to_the_north_texture
SO ./path_to_the_south_texture
WE ./path_to_the_west_texture
EA ./path_to_the_east_texture
S ./path_to_the_sprite_texture
                1111111111111111111111111111
          111111000011000000000000000000000011111
    1111110000111000000200000000000000000000000001
  11010000000000000000000000000000000W000000000001
1111011000001110000000000000000000000000000000011
10000000001100000000000011101111111111111111111
1111011111111101110000001000000111
1111011111111101110101001000011
11000000110101011100000010001
1000200000000000110000001001
1000000000000000110101001021
11000001110101011111011110011
11110111 1110101 101111010001
11111111 1111111 111111111111


               
     